............................#####..........
............................#...#..........
............................#...#..........
............................#...#..........
............................#...#..........
............................#...#..........
........................#########..........
........................#...#..............
........................#...#..............
........................#...#..............
....................#########..............
....................#...#..................
....................#...#..................
....................#...#..................
................#####...#####..............
................#...........#..............
................#...........#..............
................#...........#..............
........#########...........#####..........
........#.......................#..........
........#.......................#..........
........#.......................#..........
#######.#...................#########......
#.....#.#...................#...#...#......
#.....#.#####...............#...#...#......
#.....#.....#...............#...#...#......
###########.#.######^...#####...###########
......#...#.#.#.........#...........#.....#
......#.#########.......#...........#.....#
......#.#.#.#.#.........#...........#.....#
......#########.#########...........#######
........#.#.#...#..........................
....#########...#..........................
....#...#.#.....#..........................
....#...#.#######..........................
....#...#..................................
....#...#..................................
....#...#..................................
....#####..................................
